> print(maze, px = px_ascii)
-------------------------
-@@@@@@@@@@@@@-@@@@@@@@@-
-@-----@-----@-@-@-------
-@-@@@@@-@@@-@-@-@-@@@@@-
-@-@-----@---@-@-@-@---@-
-@-@@@-@@@-@@@-@-@@@-@-@-
-----@---@-@---@-----@-@-
-@@@-@@@-@-@-@@@@@@@@@-@-
-@-@---@-@-@-@---------@-
-@-@@@@@-@@@-@-@@@@@-@@@-
-@---------@-@-@---@-@-@-
-@@@@@@@@@-@-@-@-@@@@@-@-
-@-------@-@-@-@-------@-
-@@@@@@@-@-@-@-@-@@@-@-@-
-@-------@---@-@-@-@-@-@-
-@-@@@@@-@@@@@-@@@-@-@-@-
-@-@---@---------@-@-@-@-
-@-@@@-@-@@@@@@@-@-@-@-@-
-@---@-@-@-----@-@-@-@-@-
-@-@-@-@@@-@@@-@-@-@-@@@-
-@-@-@-----@-@-@---@-----
-@@@-@-@@@@@-@-@@@-@@@@@-
---@-@-----@-----@-----@-
-@@@-@@@@@-@@@@@@@@@@@@@-
-------------------------

