> print(as_bm_bitmap(maze), px = px_ascii)
-------------------------
-@@@@@@@@@@@@@-@@@@@@@@@-
-@-----@-----@-@-@-------
-@-@@@@@-@@@-@-@-@-@@@@@-
-@-@-----@---@-@-@-@---@-
-@-@@@-@@@-@@@-@-@@@-@-@-
-----@---@-@---@-----@-@-
-@@@-@@@-@-@-@@@@@@@@@-@-
-@-@---@-@-@-@---------@-
-@-@@@@@-@@@-@-@@@@@-@@@-
-@---------@-@-@---@-@-@-
-@@@@@@@@@-@-@-@-@@@@@-@-
-@-------@-@-@-@-------@-
-@@@@@@@-@-@-@-@-@@@-@-@-
-@-------@---@-@-@-@-@-@-
-@-@@@@@-@@@@@-@@@-@-@-@-
-@-@---@---------@-@-@-@-
-@-@@@-@-@@@@@@@-@-@-@-@-
-@---@-@-@-----@-@-@-@-@-
-@-@-@-@@@-@@@-@-@-@-@@@-
-@-@-@-----@-@-@---@-----
-@@@-@-@@@@@-@-@@@-@@@@@-
---@-@-----@-----@-----@-
-@@@-@@@@@-@@@@@@@@@@@@@-
-------------------------

> print(as_bm_bitmap(maze, walls = TRUE), px = px_ascii)
@@@@@@@@@@@@@@@@@@@@@@@@@
@-------------@---------@
@-@@@@@-@@@@@-@-@-@@@@@@@
@-@-----@---@-@-@-@-----@
@-@-@@@@@-@@@-@-@-@-@@@-@
@-@---@---@---@-@---@-@-@
@@@@@-@@@-@-@@@-@@@@@-@-@
@---@---@-@-@---------@-@
@-@-@@@-@-@-@-@@@@@@@@@-@
@-@-----@---@-@-----@---@
@-@@@@@@@@@-@-@-@@@-@-@-@
@---------@-@-@-@-----@-@
@-@@@@@@@-@-@-@-@@@@@@@-@
@-------@-@-@-@-@---@-@-@
@-@@@@@@@-@@@-@-@-@-@-@-@
@-@-----@-----@---@-@-@-@
@-@-@@@-@@@@@@@@@-@-@-@-@
@-@---@-@-------@-@-@-@-@
@-@@@-@-@-@@@@@-@-@-@-@-@
@-@-@-@---@---@-@-@-@---@
@-@-@-@@@@@-@-@-@@@-@@@@@
@---@-@-----@-@---@-----@
@@@-@-@@@@@-@@@@@-@@@@@-@
@---@-----@-------------@
@@@@@@@@@@@@@@@@@@@@@@@@@

