> print(maze2, px = px_ascii)
-------------------------
-@-@@@@@-@@+@+-@@@@+@+@+-
-@-@---@-@---@-@---@---@-
-@-@-@@@-@-+@+-@-+@+-@-+-
-@-@-@-@-@-@-----@---@-@-
-@-@-@-@-@-+@+@+@+-@@@-+-
-@-@-@---@---------@---@-
-@@@-@@@-@-@@@@@-@@+@+@+-
-------@-@-@---@---@-----
-@@@-@@@-@@@-@-@@@-+@+-@-
-@-@-@-@-----@---@---@-@-
-@-@@@-@-@@@@@-@@@-@-+-@-
-@-----@-@---@-@---@-@-@-
-@@@-@-@-@-@@@-@-+@+@+-@-
-@-@-@-@-@-@-----@-----@-
-@-@-@@@@@-@@@-+@+-@@@@@-
-@-@---------@-@-----@-@-
-@-@@@-@@@-@-@-+@+@+-@-@-
-@---@-@-@-@-@-----@-@-@-
-@-@@@-@-@-@-@@@-+@+-@-@-
-@-@---@-@-@-@---@-----@-
-@-@@@@@-@-@@@-+@+-@@@-@-
-@-------@-----@---@-@-@-
-@@@@@@@-@@+@+@+@@@@-@@@-
-------------------------

